...........................
...o........xxxx...........
...o..OOO......XX..........
.ooOOOOO........XXXX.......
.....OOOOOO........XX......
...OOOO...O.......XXXX.....
..........OO.........XX....
..........OOO........X.....
................XXXXXXX....
....................XXX....
......................XXX..
......................X....
................XXXXXXX....
...........................
...........................
